1111111111
1P1C000001
1010101101
10001E0001
1111111111