111111111111111
1000000000000E1
1000000C0000001
1P0000000000001
111111111111111